гаршнеп	болотная птица отряда
иномарка	автомобиль иностранного производства
эдельвейс	травянистое растение семейства
мышеловка	приспособление для ловли
мельница	машина для размола
ложка	предметов столового прибора
факел	место на поверхности
тенета	сеть для ловли
кондуит	россии до революции
автоматчик	специалист в области
сайда	промысловая рыба семейства
привод	устройство для приведения
теолог	специалист в области
нитка	тонкой длинной линии
самодержавие	система государственного управления
квадрат	произведение от умножения
караулка	помещение для караула
месиво	корм для скота
искусствоведение	комплекс научных дисциплин
заливное	кушанье из мяса
пятидесятница	праздников у христиан
малыш	человеке маленького роста
кладовая	помещение для хранения
морковь	кормовое растение семейства
пасха	кушанье из творога
рекреация	помещение для отдыха \| перерыв для отдыха
помост	настил из досок
большевик	член большевистской партии
казак	дону на кубани
немец	преподаватель немецкого языка \| учитель немецкого языка
ромб	офицерского знака различия
шашлык	кушанье из кусочков
садок	помещение для содержания
кпд	коэффициент полезного действия
манометр	прибор для измерения
створ	место у реки
сговор	соглашение между родителями
эхолот	прибор для измерения
волномер	прибор для измерения
бумага	материал для письма
фараон	старинной азартной игры
гильотина	орудие смертной казни
индекс	система условных обозначений
дезинфекция	средства для уничтожения
телохранитель	сотрудник личной охраны
судостроитель	специалист в области
неверность	нарушение супружеской верности
волокуша	орудие для выравнивания
кукловод	актер кукольного театра
бокал	сосуд из стекла
насморк	воспаление слизистой оболочки
олива	южное дерево семейства
яркость	количество световой энергии
альтруизм	стремление к деятельности
неправильность	уклонение от нормы
отпуск	освобождение от работы
энергетик	специалист в области
плазма	воздействием высокой температуры
зола	остаток от сжигания
жилище	помещение для жилья
коммунист	член коммунистической партии
монашество	аскетическом образе жизни
унция	введения метрической системы
грация	предмет женского туалета
ржавчина	налет на поверхности
лист	страниц печатного текста
пеструшка	птичка из семейства
улан	военный из частей
музыкант	специалист в области
болезнь	отклонение от нормы
нагреватель	прибор для нагревания
библиограф	специалист в области
житие	повествование о жизни
авиасалон	выставка новейших образцов
накладка	украшение из материи
атлетика	совокупность гимнастических упражнений
недостача	отсутствие нужного количества
естественник	студент учебного заведения
яма	место для хранения
хлеб-соль	растение из зерен
ползунок	одежда для детей
завод	приспособление для приведения
четверик	русская мера объёма
психотерапевт	специалист в области
смеситель	машина для приготовления
ученик	учащийся средней школы
реалист	ученик реального училища
спец	годы советской власти
загородка	участок для содержания
могильщик	птица из породы
выпуск	выгон для скота
субъективизм	направление идеалистической философии
сектор	сфера народного хозяйства
пыж	игра в городки
медиа	средства массовой информации
нарзан	источник минеральных вод
охлаждение	состояние полного равнодушия
маска	слепок из гипса
мастурбация	получение сексуального удовлетворения
проводник	провожатый для указания
плевательница	сосуд в к
гиацинт	декоративное растение семейства
реактор	аппарат для осуществления
рефрен	тема музыкального произведения
лиственница	хвойное дерево семейства
вмятина	углубление на поверхности
электрик	специалист в области
пылесос	аппарат для очистки
мозжечок	отдел головного мозга
филе	мясо высшего сорта
зажим	приспособление для зажимания
металлургия	отрасль тяжёлой промышленности
дерматолог	специалист в области
сифон	устройство для увеличения
крюк	приспособление для переноски
астронавт	специалист в области
методист	специалист в области
щука	пресноводная промысловая рыба
абитуриент	выпускник средней школы
мартын	птица из породы
водосбор	растение из семейства
угольник	инструмент для проверки
краска	слой на поверхности
видеокамера	аппарат для записи
радиолокатор	устройство для обнаружения
форель	промысловая рыба семейства
причет	духовенство христианского храма
пробег	нахождение в пути
баклан	водоплавающая птица отряда
биология	комплекс научных дисциплин
совет	органов государственного управления
химик	специалист в области
водолей	сосуд для умывания
механик	специалист в области
гастрит	воспаление слизистой оболочки
пророчество	воззрениям различных религий
каша	игра в городки
скотовод	специалист в области
портрет	произведение изобразительного искусства
июль	месяца календарного года
государыня	глава монархического государства
судно	сосуд для испражнений
брешь	отсутствие необходимых средств
геометр	специалист в области
клуб	эпоху великой революции
сомнение	состояние душевного разлада
трал	устройство для обнаружения
котик	изделия из меха
рукав	шланг для подачи
оживление	переход из состояния
голавль	рыба из породы
геодезист	специалист в области
ягодица	сосок женской груди
эндокринолог	специалист в области
чон	части особого назначения
нефтепровод	трубопровод для передачи
барометр	прибор для измерения
мулат	потомок от браков
бетономешалка	машина для приготовления
сущность	вопроса в сущности
киновед	специалист в области
ми	буквы греческого алфавита
этнограф	специалист в области
комитет	орган государственного управления
чувство	психическое состояние человека
журавль	перелётная птица отряда
силок	приспособление для ловли
нехватка	отсутствие нужного количества
демограф	специалист в области
судостроение	отрасль тяжелой промышленности
йога	система физических упражнений
атомщик	специалист в области
элемент	прибор для получения
минога	рыба из семейства
носилки	приспособление для переноски
феска	шапочка из фетра
флейта	духовой музыкальный инструмент
раздвоенность	состояние душевного разлада
скачка	состязания верховых лошадей
воспитанник	учащийся средней школы
революция	социалистическая революция г
валторна	музыкальный духовой инструмент
скотник	помещение для скота
радиоаппаратура	аппаратура для передачи
сверчок	насекомое из отряда
минея	книга для чтения
изнурение	состояние крайнего утомления
горшок	сосуд для мочи
хронология	раздел исторической науки
трубка	прибор для курения
студия	школа для подготовки
стопа	сосуд для вина
предостережение	мера социальной защиты
бессилие	недостаток физических сил
пробка	приспособление для закрывания
властолюбие	стремление к власти \| любовь к власти
гетера	женщина легкого поведения
красноармеец	боец красной армии \| военнослужащий красной армии
биолог	специалист в области
пюпитр	подставка для нот
форсунка	прибор для распыления
психиатр	специалист в области
косметика	средства для ухода
флорист	специалист в области
кран	устройство для управления
верша	приспособление для ловли
шредер	машина для измельчения
сопротивление	странах западной европы
уродство	отклонение от нормы
кульминация	момент наивысшего напряжения
самолюбие	чувство собственного достоинства
экзерсис	упражнение для развития
залом	рыба из породы
товарищество	коллективизации сельского хозяйства
астрофизик	специалист в области
раздевалка	помещение для хранения
фугас	заряд взрывчатого вещества
статуэтка	произведение изобразительного искусства
май	месяц календарного года
пойнтер	собака из породы
имитация	повторение музыкальной темы
морг	помещение для покойников
патронаж	покровительство со стороны
колер	состояние сильного возбуждения
шифр	система условных знаков
резец	орудие каменного века
привратник	выход из желудка
пролог	жанров древнерусской литературы
земство	россии до революции
скачки	состязания верховых лошадей
детектор	устройство для обнаружения
лубянка	изделие из луба
тетрадь	листы чистой бумаги
безразличие	состояние полного равнодушия
окрошка	кушанье из кваса
девочка	женщина легкого поведения
пуговка	кнопка электрического звонка
бюджетник	работник бюджетной организации
аконит	травянистое растение семейства
сексопатолог	специалист в области
щетинник	травянистых растений семейства
рационализм	направление в теории
акватория	поверхность водного пространства
клеть	устройство для подъема
шатен	краска для волос
усилитель	устройство для усиления
стратосфера	слой земной атмосферы
ветрогон	устройство для создания
газовик	работник газовой промышленности
бузина	настой из цветов
центрифуга	устройство для создания
лингвист	специалист в области
запасник	помещение для хранения
рыбоохрана	охрана рыбных запасов
музыковед	специалист в области
хронограф	прибор для измерения
путч	попытка государственного переворота
гарнец	мера сыпучих тел
вьюн	пресноводная рыба отряда
наклад	место на к
получка	получение заработной платы
буфет	шкаф для хранения
интервьюер	специалист в области
оперативник	офицер оперативного отдела
чеканка	способ художественной обработки
анафема	отлучение от церкви
служба	совершение в церкви
фагот	язычковый музыкальный инструмент
пожарник	работник пожарной команды
эколог	специалист в области
фаэтон	кузов легкового автомобиля
горсовет	совет народных депутатов
молокан	сорное растение семейства
шлюз	сооружение для перехода
брешь	разрыв в цепи
сиг	промысловая рыба семейства
рукопись	памятник древней письменности
природоведение	наука о природе
ветка	линия железной дороги
естествоиспытатель	специалист в области
пищуха	певчая птица отряда
домкрат	механизм для подъема
подвес	приспособление для подвешивания
чугун	сосуд округлой формы
мудрец	человек большого ума
батя	командир воинского подразделения
позитивизм	отношение к действительности
возбудимость	способность живых клеток
окулист	специалист в области
историк	специалист в области
венчик	предмет кухонной утвари
магистрат	управление в россии
залежь	месторождение полезных ископаемых
виселица	орудие смертной казни
диетолог	специалист в области
грудинка	мясо грудной части
поучение	жанр древнерусской литературы
член	лицо из числа
виадук	сооружение для перехода
психоаналитик	специалист в области
неврастения	расстройство нервной системы
лесхоз	предприятие лесного хозяйства
историограф	специалист в области
боб	травянистое растение семейства
военный	службе в армии
пропись	письмо от руки
бандура	щипковый музыкальный инструмент
сумка	приспособление для переноски
помилование	освобождение от наказания
ползунки	одежда для детей
ветеринар	специалист в области
тепляк	помещение для содержания
свирель	символ поэтического творчества
микрокосм	мир малых величин
оборот	способ словесного выражения
социолог	специалист в области
окунь	хищная рыба семейства
журавль	приспособление для подъема
дивизия	соединение военных кораблей
ставка	размер заработной платы
духобор	сект духовных христиан
бородач	хищная птица семейства
освещенность	отношение светового потока
забегаловка	продажей алкогольных напитков
отдельность	свойство горных пород
угольщик	специалист в области
синица	певчая птица отряда
мина	монета соответствующего достоинства
пачка	совокупность однородных предметов
редька	овощное растение семейства
оборачиваемость	движение транспортных средств
корабельщик	специалист в области
лак	изделия из дерева
мешок	вместилище для хранения
богослужение	совершение в церкви
свидетельство	дача свидетельских показаний
универсал	инструмент для измерения
геликон	духовой музыкальный инструмент
стекло	гладкой поверхности воды
выборка	группа однородных предметов
баба	фигура из снега
ажур	ведение бухгалтерского учета
пемза	пористая горная порода
авокадо	вечнозеленое дерево семейства
ракетчик	специалист в области
совнарком	совет народных комиссаров
ковш	созвездие большой медведицы
агроном	специалист в области
борец	травянистое растение семейства
коллегия	группа должностных лиц
обогреватель	прибор для обогревания
поп	игре в городки
амбар	строение для хранения
генетик	специалист в области
утка	сосуд для мочи
канон	повторение музыкальной темы
культура	сфера человеческой деятельности
дробь	звуки от ударов
беспокойство	состояние нервного возбуждения
исполком	исполнительного комитета совета
кипятильник	прибор для кипячения
угольщик	судно для перевозки
шоумен	специалист в области
вольность	отступление от правил \| отступление от нормы
хлеб	растение из зерен
прагматизм	направление в философии
матушка	жена духовного лица
океанография	раздел физической географии
салфетка	изделие из ткани
декабрь	месяц календарного года
шалфей	полукустарниковое растение семейства
загон	участок для содержания
изабелла	вина из винограда
торговля	отрасль народного хозяйства
злоба	чувство гневного раздражения
землеведение	раздел физической географии
трансформация	преобразование переменного тока
комик	человек веселого нрава
этап	пункт на пути
бульдог	револьвер особой системы
зеленка	корм для скота
страус	птица жарких стран
лесовоз	судно для перевозки
лира	щипковый музыкальный инструмент
впадина	понижение земной поверхности
кружка	сосуд из стекла
модератор	приспособление для регулирования
аберрация	отклонение от нормы
декрет	отпуск по беременности
монастырь	уединённом образе жизни
свеча	приспособление для воспламенения
отдача	коэффициент полезного действия
сервант	шкафа для посуды
архиерей	высших чинов духовенства
стоматолог	специалист в области
партиец	член коммунистической партии
домоводство	ведение домашнего хозяйства
юла	певчая птица отряда
лихорадка	состояние крайнего возбуждения
футляр	вместилище для хранения
палеонтолог	специалист в области
горелка	устройство для распыления
мопс	порода комнатных собак
возлияние	употребление спиртных напитков
начмед	начальник медицинской службы
улица	простор для проявления
природопользование	использование природных богатств
градусник	прибор для измерения
глубина	расстояние от поверхности
март	месяц календарного года
аллегория	выражение отвлеченного понятия
сырник	кушанье из творога
переход	сооружение для передвижения
телефонист	специалист в области
шурф	подземная горная выработка
материк	крупных частей суши
губерния	россии с начала
гидролог	специалист в области
транспорт	отрасль народного хозяйства
полати	настил из досок
интеллектуализм	направление в психологии
соболь	изделия из меха
зяблик	птица из семейства
хлопушка	травянистое растение семейства
миноискатель	прибор для обнаружения
бордо	вина из винограда
патологоанатом	специалист в области
сеть	приспособление для ловли
клемма	устройство для присоединения
выключатель	устройство для замыкания
лесник	работник лесного хозяйства
опоздание	нарушение установленного срока
тахометр	прибор для измерения
позиция	район военных действий \| район боевых действий
догматик	специалист в области
очиток	травянистое растение семейства
мулла	служитель религиозного культа
пищаль	духовой музыкальный инструмент
дизель	двигатель внутреннего сгорания
бестселлер	ряде зарубежных стран
кутья	кушанье из крупы
испаритель	прибор для измерения
сивко	птица из отряда
помидор	овощное растение семейства
контроллер	прибор для регулирования
килька	промысловая рыба семейства
папирус	травянистое растение семейства
кинематограф	прибор для демонстрации
фураж	корм для лошадей
чистоплюй	человек до крайности
лаг	прибор для определения
плечики	вешалка для платья
транспарант	лист плотной бумаги
аранжировка	переложение музыкального произведения
возмущение	отклонение небесных тел
вклад	достижение в области
вскрытие	исследование внутренних органов
коза	машина для подъема
питание	усвоение питательных веществ
западня	приспособление для ловли
черчение	предмет школьного преподавания
альфа	буквы греческого алфавита
кандидат	степень в ссср
юстиция	система судебных учреждений
иллюстрация	произведение изобразительного искусства
бык	рогатое животное отряда
лучник	стрелок из лука
аэродром	участок земной поверхности
скат	приспособление для скатывания
зоолог	специалист в области
девальвация	обесценение национальной валюты
леди	наименование замужней женщины
этюд	произведение изобразительного искусства
топор	орудие для рубки
тон	интервал темперированной гаммы
эмират	система государственного управления
силос	корм для скота
кроншнеп	птица из семейства
руководство	пособие для изучения
белорыбица	промысловая рыба семейства
кораблестроение	отрасль тяжёлой промышленности
загруженность	наличие большого количества
бройлер	помещение для выращивания
атлет	человек крепкого телосложения
колода	комплект игральных карт
глухарь	лесная птица семейства
профессор	звание преподавателя высшего
жатка	машина для скашивания
агитатор	член политической партии
катушка	стержень для наматывания
предбанник	помещение для раздевания
брусчатка	материал для мощения
мультипликатор	устройство для усиления
нечистота	содержимое выгребных ям
стыд	чувство моральной ответственности
амброзия	травянистое растение семейства
хлопчатник	однолетнее растение семейства
рябчик	травянистых растений семейства
зажигание	приспособление для воспламенения
соха	старину на руси
балкон	места для зрителей
репатриация	возвращение на родину
исход	книга ветхого завета
кран	машина для подъема
куколь	сорное растение семейства
плотва	пресноводная рыба семейства
октябрь	социалистическая революция г
техник	специалист в области
терапевт	специалист в области
кошель	приспособление для ловли
счетовод	специалист в области
девятка	отметка об успеваемости
отдых	остановка в пути
океанограф	специалист в области
антрополог	специалист в области
ореол	сияние вокруг головы
кинза	травянистое растение семейства
пробник	прибор для взятия
драхма	единица аптекарского веса
ротвейлер	порода служебных собак
чемодан	снаряд крупного калибра
станок	машина для обработки
дочь	лицо женского пола
лебедка	машина для подъема
спасение	избавление от опасности
радиопередача	передача по радио
интернат	специализированное учебное заведение
эсэсовец	член фашистской организации
ствол	устройство для получения
трясогузка	птица из отряда
радиоприемник	аппарат для приема
власть	органы государственного управления
цапля	болотная птица отряда
отупение	состояние крайней усталости
господин	дворянском обществе человек
лук	луковичное растение семейства
рыбак	любитель рыбной ловли
примус	прибор для приготовления
йота	буква греческого алфавита
телефон	аппарат для осуществления
апрель	месяца календарного года
стряпка	помещение для приготовления
медалист	выпускник средней школы
масленка	устройство для подачи
стабилизатор	устройство для поддержания
шток	месторождение полезного ископаемого
эпос	произведения народного творчества
специалист	работник в области
снегирь	певчая птица отряда
копи	месторождение полезных ископаемых
ведомость	газет в россии
глобус	модель земного шара
развалины	скопление каменных глыб
лавр	венок из листьев
брасс	способ спортивного плавания
пророк	воззрениям различных религий
редис	овощное растение семейства
длительность	протяженность во времени
кузнечик	насекомое из отряда
пятидесятник	командир воинского подразделения
камера	помещение специального назначения
металлург	специалист в области
ревизия	перепись в россии
уключина	приспособление для укрепления
бурав	инструмент для сверления
войско	совокупность вооруженных сил
метла	предмет хозяйственного обихода
корж	лепешка из муки
тормоз	устройство для снижения
флюгер	прибор для измерения
театральность	совокупность характерных свойств
динамо-машина	генератора постоянного тока
аудит	проверка финансовой деятельности
подворье	дом в городе
параша	сосуд для испражнений
прибой	место у берега
затейник	организатор массовых игр
молочник	сосуд для молока
грамота	начальные сведения знания
вездеход	автомобиль для передвижения
фронт	совокупность вооруженных сил
синоптик	специалист в области
глушитель	устройство для снижения
угар	состояние крайнего возбуждения
признание	объяснение в любви
алоэ	травянистое растение семейства
почтмейстер	начальник почтовой конторы
коммутатор	устройство для замыкания
депо	место для хранения
ля	звук музыкальной гаммы
сокровищница	помещение для хранения
возвышенность	участок земной поверхности
полусвет	женщинах лёгкого поведения
апокалипсис	книг нового завета
нитрат	соль азотной кислоты
кош	приспособление для ловли
плавание	полёт космического корабля
фольклорист	специалист в области
дипломат	пальто особого покроя
затравка	средство для возбуждения
протодьякон	дьякон высшего чина
ум	человек с точки
выемка	вырез у платья
караул	группа вооруженных людей
кафедра	возвышение для оратора
спокойствие	состояние душевного покоя
цифра	знак для обозначения
совпартшкола	школа для подготовки
тмин	травянистое растение семейства
дельта	буквы греческого алфавита
султан	титул верховного правителя
картограф	специалист в области
бур	инструмент для сверления
культурность	уровень культурного развития
выбоина	углубление на поверхности
хирург	специалист в области
партизан	участник вооруженной борьбы
кашалот	млекопитающее из отряда
детектив	агент сыскной полиции
вольтметр	прибор для измерения
взрывник	специалист в области
фрау	наименование замужней женщины
ортопед	специалист в области
девушка	лицо женского пола
забытье	состояние сильного возбуждения
здравница	учреждение для лечения
иволга	певчая птица отряда
любовь	чувство глубокой привязанности
ускоритель	установка для получения
гараж	помещение для стоянки
поддон	сеть для ловли
потенциометр	прибор для измерения
щавель	травянистое растение семейства
метеоролог	специалист в области
кроль	стиль спортивного плавания
философ	студент философского факультета
психология	совокупность психических процессов
кофейник	сосуд для варки
ссора	столкновение противоположных сторон
юриспруденция	совокупность юридических наук
си	звук музыкальной гаммы
кролик	изделия из меха
повар	специалист в области
непринятие	отказ от принятия
бас	духовой музыкальный инструмент
гран	единица аптекарского веса
скворец	певчая птица отряда
замок	приспособление для запирания
орнитолог	специалист в области
тупость	ограниченность умственных способностей
герцог	титул высшего дворянства
лазер	прибор для получения
литературовед	специалист в области
лучок	приспособление для ловли
унитаз	раковина в уборной
дискотека	зал для танцев
наживка	приманка для ловли
какао	порошок из семян
зарядка	совокупность гимнастических упражнений
циркуль	инструмент для вычерчивания
икс	буквы латинского алфавита
индикатор	прибор для измерения
гробница	сооружение из камня
баловень	человек к рого
конфликт	столкновение противоположных сторон
косметолог	специалист в области
игуменья	настоятельница женского монастыря
кораблестроитель	специалист в области
статистик	специалист в области
инструментовка	изложение музыкального произведения
ботаник	специалист в области
колея	след от колеса
радиопередатчик	аппарат для передачи
комната	помещение специального назначения
авиатор	специалист в области
покалывание	время от времени
дисциплина	отрасль научного знания \| отрасль научных знаний
выработка	размер заработной платы
цивилизация	уровень общественного развития
померанец	вечнозеленое дерево семейства
луг	участок земной поверхности
вход	место для прохода
сойка	перелетная птица отряда
херес	вина из винограда
лицо	человек с точки
окисел	соединение химического элемента
индукция	возбуждение электродвижущей силы
капсюль	стержень на к
капитуляция	прекращение военных действий
сретение	праздников православной церкви
тяга	совокупность технических устройств
пальма	дерево южных стран
равелин	равелинов петропавловской крепости
морфий	алкалоид опийного мака
рок	основой молодёжной культуры
гусь	крупная водоплавающая птица
лаборатория	помещение для проведения
угольщик	работник угольной промышленности
пион	декоративное растение семейства
француз	преподаватель французского языка
жизнелюбие	любовь к жизни
классик	специалист в области
клозет	помещение для отправления
апелляция	обжалования судебных решений
иск	средство судебной защиты
пуля	снаряд для стрельбы
минералог	специалист в области
трап	аппарат для отделения
эмиссия	выпуск ценных бумаг
шпроты	промысловая рыба семейства
ранец	сумка из кожи
гуляш	кушанье из кусочков
грелка	прибор для обогревания
плечико	вешалка для платья
кружало	встарину в россии
урна	сосуд для хранения
рябинка	полукустарниковое растение семейства
чиж	певчая птица семейства
баня	прибор для нагревания
пластика	совокупность выразительных средств
озорство	нарушение общественного порядка
бочка	цистерне для перевозки
церковнослужитель	служитель в церкви
микробиолог	специалист в области
террариум	помещение для содержания
ординарец	офицер для поручений
шлагбаум	перекладина для открытия
посуда	предметы домашнего обихода
сексолог	специалист в области
кош	место постоянного пребывания
талия	комплект игральных карт
комендант	начальник хозяйственной части
путеец	специалист в области
уровень	прибор для проверки
ре	звук музыкальной гаммы
держатель	приспособление для держания
клоунада	жанр циркового искусства
депрессия	понижение земной поверхности
бочка	фигура высшего пилотажа
ключ	время военных действий
шаблон	инструмент для измерения
экономист	специалист в области
ковш	совок для зачерпывания
епископат	система церковного управления
физиолог	специалист в области
стрела	приспособление для подъема
соль	звук музыкальной гаммы
эдикт	указ верховной власти
сериал	телевидении в кино
мультипликатор	прибор при помощи
пертурбация	отклонение небесных тел
экономайзер	прибор для нагревания
становище	место временного расположения
герпес	заболевание у человека
лоток	совок для зачерпывания
ручей	углубление на поверхности
финка	лошадь северной породы
препятствие	преграда на пути
геолог	специалист в области
крест	движением правой руки
массовик	организатор массовых игр
ливр	франции до г
амперметр	прибор для измерения
девиация	отклонение магнитной стрелки
мостки	настил из досок
патрон	образец для кройки
теплообменник	аппарат для передачи
бочка	введения метрической системы
простак	персонаж драматического произведения
распашонка	рубашка особого покроя
кварта	ступень диатонического звукоряда
термостат	устройство для поддержания
выставка	увольнение со службы
завещатель	лицо от имени
аршин	русская мера длины
минтай	промысловая рыба семейства
ы	буква русского алфавита
шифоньер	шкаф для одежды
подозрение	предположение о возможности
подсознание	совокупность психических процессов
щуп	инструмент для измерения
институт	среднее учебное заведение
моряк	ветер с моря
заслонка	приспособление для закрывания
радиатор	устройство для охлаждения
глубиномер	прибор для измерения
машинист	работник железнодорожного транспорта
ходок	выборный от крестьян
хождение	жанр древнерусской литературы
держава	приспособление для держания
сноб	дворянском обществе человек
офицер	лицо командного состава
птица	человеке с точки
колпачок	гриб из семейства
скамейка	приспособление для сидения
финансист	специалист в области
правительство	группа должностных лиц
огородничество	отрасль сельского хозяйства
дезодорант	средство для уничтожения
реостат	прибор при помощи
видоизменение	изменение внешнего вида
видеомагнитофон	аппарат для записи
грейпфрут	плодовое дерево семейства
мандрагора	многолетнее травянистое растение
судок	приспособление для переноски
непризнание	отказ от признания
короб	изделие из луба
прелюбодеяние	нарушение супружеской верности
подкорка	скопление нервных клеток
орудие	средство для достижения
старшеклассник	ученик старшего класса
орлан	хищная птица семейства
горловина	вырез у платья
крот	изделия из меха
покровительство	обеспечение благоприятных условий
богатырь	человеке высокого роста \| человек большого роста
революционер	участник революционного движения
волчок	отверстие в двери
церковь	сооружение культового назначения
капиталист	представитель господствующего класса
зажигалка	прибор для получения
диктофон	аппарат для записи
завком	комитет профессионального союза
устой	слой на поверхности
нона	ступень диатонической гаммы
сердечник	специалист в области
надир	точка небесной сферы
корреспонденция	сообщение с мест
корсет	принадлежность женской одежды
уха	суп из рыбы
радиоизлучение	излучение электромагнитных волн
патриаршество	система церковного управления
квартира	место временного расположения
старшекурсник	студент старшего курса
щегол	певчая птица отряда
гальванометр	прибор для измерения
гуща	место наибольшего скопления
схватка	приспособление для скрепления
грибница	теплица для выращивания
дуршлаг	предмет кухонной утвари
лесовод	специалист в области
насилие	применение физической силы
курай	музыкальный инструмент род
прут	изделие из металла
свита	женская народная одежда
четверть	русская мера объема
налим	пресноводная рыба семейства
электромагнит	устройство для получения
технолог	специалист в области
грудка	мясо грудной части
теософия	учение о возможности
шпингалет	задвижка для запирания
декоратор	специалист в области
фанфара	музыкальный инструмент род
рынок	система общественных отношений
педиатр	специалист в области
эксцесс	нарушение общественного порядка
ларец	ящик для хранения
севрюга	промысловая рыба семейства
филолог	студент филологического факультета
гигиенист	специалист в области
земля	планета солнечной системы
тимус	железа внутренней секреции
конверсия	конверсия военного производства
палитра	совокупность выразительных средств
наколка	украшение из материи
иван-чай	многолетнее травянистое растение
оранжерея	помещение для выращивания
книжонка	книга в и
девятка	игры в карты
прорезь	судно для перевозки
славка	певчая птичка отряда
теплица	помещение для выращивания
ритмика	система физических упражнений
партийность	принадлежность к партии
манго	плодовое дерево семейства
серия	ряд однородных предметов
вокзал	здание для обслуживания
январь	месяц календарного года
рогожка	ткань полотняного переплетения
голодовка	отказ от пищи
сентябрь	месяц календарного года
раздражение	реакция живой клетки
запор	приспособление для запирания
переворот	фигура высшего пилотажа
проказа	инфекционное заболевание человека
опасение	предположение о возможности
ремень	полоса вдоль спины
долото	инструмент для обработки
новость	товар нового сорта
гуталин	мазь для чистки
россыпь	скопление каменных глыб
сито	прибор для определения
животноводство	отрасль сельского хозяйства
параллель	друг от друга
археолог	специалист в области
фрейлейн	наименование незамужней женщины
романист	специалист в области
вышина	протяженность по вертикали
трансформатор	устройство для преобразования
гомеопат	специалист в области
анатом	специалист в области
нарцисс	луковичное растение семейства
колонка	установка для отпуска
олеография	копия с картины
поликлиника	лечебно профилактическое учреждение
правосудие	деятельность судебных органов
вожак	руководитель общественного движения
укроп	огородное растение семейства
резистор	элемент электрической цепи
батька	командир партизанского отряда
арбитраж	разрешение спорных вопросов
лебеда	сорное растение семейства
мера	средство для осуществления
базар	место для торговли
ампула	сосуд для хранения
автоматизация	применение технических средств
жаворонок	птица из семейства
собаковод	специалист в области
стихия	явление общественной жизни
заскок	отклонение от нормы
отлив	приспособление для стока
невропатолог	специалист в области
комиссия	учреждение специального назначения
школа	направление в области
отдел	частей на к
медик	специалист в области
лиса	изделия из меха
юрист	студент юридического факультета
дубонос	певчая птица семейства
циклон	аппарат для очистки
самоиндукция	возбуждение электродвижущей силы
кацавейка	женская народная одежда
козлище	овец от козлищ
возбуждение	реакция живой клетки
концентрат	корм для скота
скала	участок земной поверхности
курсант	воспитанник военного училища
навигатор	специалист в области
тальник	заросли кустарниковой ивы
повойник	русский головной убор
газоанализатор	прибор для определения
танкер	судно для перевозки
астра	декоративное растение семейства
гипертония	повышение кровяного давления \| повышение артериального давления
сардинка	рыбка из семейства
пеликан	водоплавающая птица отряда
кофе	порошок из семян
привал	остановка в пути
нумизматика	раздел исторической науки
логопед	специалист в области
керосинка	сосуд для хранения
обезьяна	изделия из меха
касса	счет бухгалтерского учета
каппа	буквы греческого алфавита
пансион	общежитие для учащихся
священнослужитель	служитель религиозного культа
измена	нарушение супружеской верности
дезертирство	уклонение от исполнения
выкройка	образец для кройки
чара	сосуд для питья
ковчег	вместилище для хранения
формация	совокупность горных пород
рок-музыка	основой молодёжной культуры
терция	ступень диатонической гаммы
флегма	человек флегматического темперамента
синтез	метод научного исследования
венеролог	специалист в области
ихтиолог	специалист в области
кювет	канава для стока
выход	обнажение горных пород
обезьяна	животное из отряда
тау	буквы греческого алфавита
группа	человек животных растений
бокал	сосуд для вина
гардероб	шкаф для одежды
акр	мера земельной площади
погреб	помещение для хранения
слабость	недостаток физических сил
ключ	приспособление для запирания
аритмия	нарушение сердечного ритма
пэр	титул высшего дворянства
птичник	помещение для содержания
пейджер	устройство для приема
поддавки	игре в шашки \| игры в шашки \| игра в шашки
код	система условных знаков
корова	рогатое животное отряда
змейка	фигур высшего пилотажа
сила	способность живых существ
тимпан	ударный музыкальный инструмент
сосуд	изделие из стекла
куб	сосуд цилиндрической формы
электрометр	прибор для измерения
мутовка	предмет домашней утвари
великан	человек огромного роста
подмостки	настил из досок
самка	особь женского пола
капитуляция	отказ от продолжения
медвежатник	охотник на медведей \| охотник на медведя
гауптвахта	помещение для содержания
причащение	обрядов христианской церкви
аномалия	отклонение от нормы
медпункт	пункт медицинской помощи
середняк	человек среднего возраста
тростник	многолетнее растение семейства
пакгауз	склад для хранения
философ	специалист в области
онколог	специалист в области
вилка	предметов столового прибора
апатия	состояние полного равнодушия
поводырь	провожатый для указания
кошка	изделия из меха
лебедь	перелетная птица семейства
сезам	травянистое однолетнее растение
хронограф	памятник древней письменности
архитектор	специалист в области
лот	прибор для измерения
клевер	травянистое растение семейства
весельчак	человек веселого нрава
шлак	остаток от сжигания
брюшко	живот у человека
мажордом	эпоху раннего средневековья
пресс-атташе	сотрудник дипломатического представительства
личность	человек с точки
выпивка	употребление спиртных напитков
рысь	изделия из меха
винт	приспособление для приведения
сеновал	помещение для хранения
банан	заколка для волос
житница	помещение для хранения
аккумулятор	устройство для накопления
сирена	устройство для получения
женщина	лицо женского пола
литератор	специалист в области
тяпка	орудие для рубки
гамма	буквы греческого алфавита
мид	министерство иностранных дел
дорога	место для прохода
поле	множество однородных предметов
малиновка	певчая птица семейства
посылка	основание для вывода
соль	вещество белого цвета
мобилизация	перевод вооруженных сил
блок	приспособление для подъема
рабовладелец	представитель господствующего класса
патриотизм	любовь к родине
щур	певчая птица семейства
муниципалитет	орган местного самоуправления
декрет	акт высших органов
термометр	прибор для измерения
куртизанка	женщина легкого поведения
оклад	размер заработной платы
сериал	совокупность художественных произведений
колонка	ряд коротких строк
газопровод	трубопровод для передачи
азот	газ без цвета
кукольник	актер кукольного театра
белена	травянистое растение семейства
совнархоз	совет народного хозяйства
светец	подставка для лучины
халифат	система государственного устройства
розетка	устройство для присоединения
респиратор	прибор для защиты
порт	место для стоянки
писсуар	раковина в уборной
кичка	праздничный головной убор
местожительство	место постоянного проживания
поставец	сосуд для питья
коромысло	насекомое из отряда
ластик	шелковистая хлопчатобумажная ткань
совок	гражданине советского союза
труба	медный музыкальный инструмент
баядерка	женщина легкого поведения
менеджер	специалист в области
гусли	щипковый музыкальный инструмент
ревень	многолетнее растение семейства
полеводство	отрасль сельского хозяйства
сон	состояние полного покоя
оговорка	ошибка в речи
новообразование	появление новых форм
овчарка	порода служебных собак
гоголь	птица из породы
норка	изделия из меха
икона	произведение изобразительного искусства
метис	потомок от брака
заря	зари до зари
перфоратор	прибор для пробивания
дивизион	соединение военных кораблей
леность	склонность к лени
корыто	предмет хозяйственного обихода
лот	группа однородных предметов
ресторан	предприятие общественного питания
кречет	хищная птица семейства
задвижка	приспособление для закрывания
тупоумие	ограниченность умственных способностей
письмо	система графических знаков
чтец	человек в обязанности
стоянка	место временного расположения
кофеварка	сосуд для варки
натюрморт	жанр изобразительного искусства
однодворец	лицо из числа
мизантропия	отчуждение от людей
кооператор	деятель в области
гипноз	воздействие на человека
подойник	сосуд в к
вырезка	мясо высшего сорта
нечистоты	содержимое выгребных ям
монолог	речь действующего лица
прихожанин	член религиозной общины
нить	тонкой длинной линии
часть	область практической деятельности
письменность	система графических знаков
галка	птица из семейства
тюльпан	декоративное растение семейства
коммутация	преобразование переменного тока
богослов	специалист в области
присутствие	исполнение служебных обязанностей
кантата	вокально инструментальное произведение
преобразователь	устройство для преобразования
шелковица	плодовое дерево семейства
пудель	порода комнатных собак
немка	учительница немецкого языка
полотенце	изделие из ткани
федерализм	принцип государственного устройства
боевик	член боевой дружины
заглушка	приспособление для закрывания
бытие	книги ветхого завета
лимон	вечнозеленое цитрусовое дерево
особа	лицо женского пола
бульдог	собака особой породы
театр	совокупность драматических произведений
тунец	хищная рыба семейства
операция	выполнение отдельной задачи
уран	планета солнечной системы
естественник	специалист в области
наследственность	способность живых существ
залежи	месторождения полезных ископаемых
зонтик	козырек для защиты
оправка	приспособление для крепления
черноморец	моряк черноморского флота
транскрипция	переложение музыкального произведения
август	месяц календарного года
биохимик	специалист в области
животновод	специалист в области
текучесть	свойство твёрдых тел
газопровод	сооружение для подачи
парусина	ткань полотняного переплетения
прогимназия	общеобразовательное учебное заведение
волк	хищное животное семейства
танцплощадка	площадка для танцев
химия	отрасль химической промышленности
управа	россии до г
лицо	верхняя сторона предмета
филолог	специалист в области
электропередача	передача электрической энергии
аэробика	комплекс физических упражнений
тамбурин	музыкальный инструмент род
черемша	луковичное растение семейства
нимб	сияние вокруг головы
рыжик	травянистое растение семейства
водник	работник водного транспорта
дрозд	птица из семейства
народность	совокупность национальных черт
дальномер	прибор для определения
шпинат	кушанье из листьев
емкость	сосуды для хранения
статика	раздел теоретической механики
кубрик	помещение для команды
марс	солнца больших планет
ню	жанр изобразительного искусства
пакет	ряд однородных предметов
осьминог	животное из отряда
танк	резервуар для хранения
гармонист	специалист в области
альянс	объединение отдельных лиц
такси	автомобиль для перевозки
октябрь	месяца календарного года
ар	мера земельной площади
хрен	овощное растение семейства
лесоводство	наука о природе
весы	прибор для измерения
иносказание	выражение отвлеченного понятия
гусар	военный из частей
коршун	хищная птица семейства
руль	устройство для управления
восстановитель	средство для восстановления
ипотека	залог недвижимого имущества
плашка	инструмент при помощи
уголовник	специалист в области
колледж	среднее учебное заведение
измор	гибель от голода
междуцарствие	период в жизни
база	склад для хранения
ферт	руки в бока
алхимия	направление в химии
отдушина	отверстие для выхода
зверобой	охотник на зверей
раскол	россии с середины
новь	хлеб нового урожая
баритон	духовой музыкальный инструмент
голь	люди разных сословий
штамп	инструмент для обработки
спираль	фигура высшего пилотажа
голиаф	человек огромного роста
мультипликатор	специалист в области
подъемник	устройство для подъема
консульство	период в истории
затея	занятие для развлечения
автосалон	выставка новейших образцов
гидроусилитель	устройство для усиления
стилист	специалист в области
языковед	специалист в области
светильня	подставка для лучины
нефтянка	судно для перевозки
бактериолог	специалист в области
настил	поверхность из досок
ноябрь	месяц календарного года
инжир	плодовое дерево семейства
пройма	прибор для определения
туалет	помещение для отправления
тамбур	музыкальный инструмент род
компас	прибор для определения
злато	изделия из золота
балахон	крестьянская верхняя одежда
собака	изделия из меха
пульверизатор	прибор для распыления
часы	прибор для определения
письменность	совокупность письменных памятников
ложа	место у стены
ель	вечнозеленое дерево семейства
селекционер	специалист в области
постав	машина для обработки
флотилия	соединение военных судов
штамп	машина для резки
довольство	чувство внутреннего удовлетворения
радиостанция	совокупность технических устройств
зонд	прибор для определения
форель	кушанье из мяса
ревизор	лицо командного состава
марс	планета солнечной системы
сом	хищная рыба семейства
голец	пресноводная рыба семейства
недоверие	сомнение в достоверности
муфта	устройство для соединения
салон	предприятие бытового обслуживания
регистр	орган государственного надзора
вакса	средство для ухода
левит	книга ветхого завета
окно	отверстие для выхода
государь	глава монархического государства
анестезиолог	специалист в области
исступление	состояние крайнего возбуждения
стилистика	совокупность выразительных средств
мерило	основанием для оценки
полпред	посол в ссср
стан	место временного расположения
анис	травянистое однолетнее растение
эфес	рукоятка холодного оружия
миска	предмет домашней утвари
корнет	россии до революции
гектар	мера земельной площади
органик	специалист в области
россказни	сомнение в достоверности
дорога	средство для достижения
пеночка	птица из семейства
радиовещание	передача по радио
пропагандист	член коммунистической партии
сопротивление	элемент электрической цепи
бухгалтер	специалист в области
люцерна	кормовое растение семейства
смолокур	специалист в области
камера	собрание народных представителей
шип	промысловая рыба семейства
книгохранилище	помещение для хранения
ларец	ящичек для хранения
хореограф	специалист в области
товаровед	специалист в области
пиала	сосуд для питья
дошкольник	ребёнок дошкольного возраста \| ребенок дошкольного возраста
орган	клавишный музыкальный инструмент
браслет	изделие из металла
интернат	общежитие для учащихся
адонис	многолетнее травянистое растение
муфта	принадлежность женской одежды
этюдник	папка для хранения
детонатор	заряд взрывчатого вещества
ландыш	травянистое растение семейства
совет	органа государственной власти
телеграф	устройство для передачи
десятина	единица земельной площади
аудитор	должность судебного следователя
фасоль	травянистое растение семейства
камелия	женщина легкого поведения
храп	прибор для взятия
рекомбинация	расположение составных частей
магнитофон	аппарат для записи
собачник	помещение для содержания
крепление	приспособление для скрепления
горошек	травянистых растений семейства
фонтан	устройство для подачи
радар	устройство для обнаружения
чехол	принадлежность женской одежды
ложе	место для спанья
жизненность	способность живого существа
горбыль	промысловая рыба отряда
культиватор	орудие для рыхления
флаг-офицер	лицо командного состава
ножницы	инструмент для резания
жилет	одежда без рукавов
баррикада	сооружение из бревен
тройка	отметка об успеваемости
новинка	товар нового сорта
жена	лицо женского пола
папство	система церковного управления
скатерть	изделие из ткани
пи	буквы греческого алфавита
микромир	мир материальных частиц
тишина	состояние душевного покоя
востоковед	специалист в области
конюшня	помещение для содержания
курильница	прибор для сжигания
камелия	растение из семейства
хата	украине в белоруссии
пробка	наружный слой коры
караул	крик о помощи
пистолет	ручное огнестрельное оружие
валун	обломок горной породы
алкоголь	класс органических соединений
тиснение	способ художественной обработки
ранец	сумка для ношения
дом	место постоянного проживания
нарколог	специалист в области
секунда	ступень диатонической гаммы
июнь	месяца календарного года
кедр	вечнозеленое дерево семейства
поплавок	прибор для регулирования
жерех	промысловая рыба семейства
стажировка	прохождение испытательного срока
стерлядь	промысловая рыба семейства
нож	инструмент для резания
благотворительность	оказание материальной помощи
фа	нот музыкальной гаммы
прерыватель	устройство для замыкания
международник	специалист в области
протодиакон	дьякон высшего чина
ленца	наклонность к лени
клюв	образование у птиц
фармаколог	специалист в области
куб	произведение от умножения
приемник	устройство для приема
текстура	расположение составных частей
кокошник	русский головной убор
железнодорожник	работник железнодорожного транспорта
лисица	изделия из меха
картер	приспособление для защиты
аист	перелётная птица отряда
астроном	специалист в области
славист	специалист в области
сотка	единица земельной площади
корт	площадка для игры
стойло	помещение для содержания
межа	граница земельных участков
альт	смычковый музыкальный инструмент
пресс-релиз	сообщение для печати
аффект	состояние сильного возбуждения
пищевод	отдел пищеварительного тракта
стекляшка	здании из стекла
седалище	место для сидения
путеец	студент учебного заведения
повеление	указ верховной власти
лахудра	женщина лёгкого поведения
пульт	подставка для нот
бета	буквы греческого алфавита
терминал	устройство в эвм
сценарий	список действующих лиц
наган	револьвер особой системы
каток	приспособление для скатывания
намет	сеть для ловли
бурса	общежитие для учащихся
минерализация	разложение органических веществ
охотовед	специалист в области
тиски	приспособление для зажима
геофизика	комплекс научных дисциплин
птица	животное из класса
соловей	певчая птица отряда
рапсодия	вокально инструментальное произведение
ярус	пласт земной коры
передатчик	аппарат для передачи
овощехранилище	помещение для хранения
пихта	хвойное дерево семейства
бескозырка	фуражка без козырька
омуль	рыба из породы
мех	одежда из меха
мост	сооружение для перехода
слабоумие	заболевание нервной системы
караульня	помещение для караула
вентиль	приспособление для изменения
кардиолог	специалист в области
анонимка	письмо без подписи
тысяцкий	выборный от крестьян
столбец	ряд коротких строк
драматургия	совокупность драматических произведений
штуцер	ружьё крупного калибра
арахис	травянистое растение семейства
синьора	наименование замужней женщины
локатор	устройство для определения
мокрица	сорное растение семейства
оборона	система оборонительных сооружений
скрипка	смычковый музыкальный инструмент
табак	декоративное растение семейства
криминалист	специалист в области
паноптикум	музей восковых фигур
кабриолет	кузова легкового автомобиля
верблюд	животное из породы
аэровокзал	здание для обслуживания
шлепок	звук от удара
расстрига	служитель религиозного культа
приход	поступление денежных средств
полицай	числа местного населения
бурдюк	мешок из шкуры
корабль	судно военного флота
спелеолог	специалист в области
парник	помещение для выращивания
изнеможение	состояние крайней усталости
ролл	машина для размола
гипофиз	железа внутренней секреции
ловушка	приспособление для ловли
фоторобот	устройство для получения
гимнастика	упражнения для развития
топограф	специалист в области
аграрий	специалист в области
малица	народов крайнего севера
станок	приспособление для укрепления
волюнтаризм	направление идеалистической философии
теплота	ощущение внутреннего тепла
выпрямитель	устройство для преобразования
эпидемиолог	специалист в области
маслина	плодовое дерево семейства
штопор	фигур высшего пилотажа
конденсатор	устройство для накопления
сарафан	платье без рукавов
выпуск	устройство для приема
привратник	сторож у ворот
фреза	машина для измельчения
мех	мешок из шкуры
гирлянда	ряд однородных предметов
психолог	специалист в области
георгин	многолетнее растение семейства
причт	духовенство христианского храма
обувь	изделие из кожи
плевел	травянистых растений семейства
монах	член религиозной общины
шарашка	годы сталинских репрессий
широковещание	передача по радио
волна	явлении в жизни
су	франции до г
битюг	порода рабочих лошадей
изотоп	атом химического элемента
континент	крупных частей суши
гинеколог	специалист в области
лабаз	помещение для хранения
сетка	сумка для ношения
гонг	ударный музыкальный инструмент
политика	система государственных мероприятий
медведь	изделия из меха
формообразование	появление новых форм
снежник	место наибольшего скопления
звонок	устройство для подачи
надзор	деятельности государственных органов
лечебница	учреждение для лечения
феодал	представитель господствующего класса
папа	глава католической церкви
фонограф	прибор для записи
обоз	совокупность перевозочных средств
офтальмолог	специалист в области
сиська	сосок женской груди
сепаратор	аппарат для отделения
стража	группа вооруженных людей
гордость	чувство собственного достоинства
логовище	место для спанья
постель	место для спанья
террор	угроза физической расправы
верста	человек высокого роста
герой	главное действующее лицо
баба	мужчина робкого нрава
высота	протяженность по вертикали
мадам	россии до г
лафит	вина из винограда
румба	танец четырехдольного размера
снг	содружество независимых государств
кокотка	женщина легкого поведения
беркут	хищная птица семейства
энтомолог	специалист в области
свисток	приспособление при помощи
исключение	уклонение от нормы
кулик	болотная птица семейства
ми	нот музыкальной гаммы
башмак	термин для обозначения
павиан	обезьяна из рода
электротехник	специалист в области
расстояние	различие в степени
трансфер	перевод иностранной валюты
хранилище	помещение для хранения
архипастырь	высших чинов духовенства
сторожка	помещение для сторожа
февраль	месяц календарного года
ностальгия	тоска по родине
постановление	акт высших органов
гак	мера земельной площади
снегоход	автомобиль для передвижения
рислинг	вина из винограда
ширпотреб	товары широкого потребления
вселенная	население земного шара
шлейф	орудие для выравнивания
морошка	полукустарниковое растение семейства
уролог	специалист в области
регентство	пребывание в должности
безвкусие	отсутствие хорошего вкуса
машиностроитель	специалист в области
апельсин	вечнозеленое цитрусовое дерево
